1  3  5 -1 -1 -1 -1 -1
2 -1 -1 -1 -1 -1 -1 -1
2 -1 -1 -1 -1 -1 -1 -1
2 -1 -1 -1 -1 -1 -1 -1
2  3  4 -1 -1 -1 -1 -1
2 -1 -1 -1 -1 -1 -1 -1
2  6  6  6  6 -1  6  6
7  7  7  7  7  9  7  7
