1  2  2 -1 -1  -1 -1 -1
2   6  6  6  6  9  6  3
 3 -1 -1 11 17  4 -1 -1
10 -1 -1 8 12  4 -1  -1
10 -1 15 14 13  4 -1 -1
10  2 16 -1 19  4 18  5
10  7  7  20 7  4 -1 -1
